\.................-....-.-.|....................|......./.|.\................|...........|....--..............
............-...................|.............|..-.......-/..............-....\...............................
|.......//...........................................|...............-......../.....\....................\....
....|......-.-.............-......\.....\......../..................../.......................................
..\..\../................../.............-............|....-.........................|......|...............|.
-..|........................./.................\.........\./.............\..|..-...-.............\............
.\......||-..................../................-................./....|........................|.............
..............\./...........-.........../-................-.........\...\........../-.......|.................
....-..........-.-.....\......................../.......-..........-/.....................||................|.
./..........|/............................\./............................./....../........\...-|............\-
........\.............................-...../............---...........|...............|......\\..............
........//....|.\......./...\.............|..............\............./...........-.|..-.............|.......
...................\...........-/..-......\...|........-.|................\-.......|........\.................
|.|....../|............\./..-........\..............................-.....................|....../............
............-....................-..............-..-................|.//.............-.............-..........
..........-.......-......|-................./........../...\........-.......................-..\.......\......
................../....|............-....../................./.....................|.................-........
...\..............--..|.....||.....\.............\../................................................-.-...../
.........-......|....-.................-.......\-................./..|...................|\.....\.....|.|-....
......................-......................-............/....................\...../...\..../...............
...../......-...............\...-....|......../.........\................................|.........../........
........../.......\..............-...............\........-|....-......-.............|...........|........./..
./...............\....../....../..../...................................................|.....|.|../......./..
....|\........\-...../...................-.............\.\..................................././..........\...
....................................-..../......................-..///......-...|.|..........................|
.........-\.....-...........|........./..........-..\.....\./...................-........................-....
....../.......././......--.....|.\..-...-....\..........................-....-...-..|.|.....|.......\-./......
...-....................-................|.............-../........|../........-.............|\...............
...../...........-......../................|................|.....\.....-.............../...|....../\.........
./...\.....\..-./.........................|................................-....................-.............
.............\|.../....\\.....\..|...........\.....................|......|.|.....|.....-............\.\......
........................|......-..........-.../......-........|...../.\|...-................................|.
.......\...-...\..........|.....\...................\.........|..........-/.........\...................../...
.-|.......|............./..|./....-.../...\............-......../..............-.......//...-...........||.\..
..|..\./..-........\..|....-..\.........../..............................|..\..................../..|...../-..
.|.........-.\...........................\..../......./....||............\..........|............-.\|.........
....................\..../|............................\.../..|........./...../............||........\....../.
....................../.....|...................|......|.................|..|.......|................|........
.....................\.........-..../.........../../..-......\.................|.../....................../...
........\.-................/........\...../....../.|.\...|/../..........................................-.....
....................................|......./...../............-................-/..|.-....................\..
..|.........................-....................../...|.....|.............../.........../.....|\.............
.......................................|.\.|.......................-.......|..............\............-./....
..........//................\..|./................-.................-..../../|................................
.|......................................./............/..-.......-.|.........................\|..|............
............................/.-..................-./..../..............|-.........-|..........................
.................-...|................\.........|\...............................\...........\...//...........
........\..|.|--.............|.......\.................|......|\./.........................\.|................
.-|.............|\|.....\|././...|..\.............\..\...................\...........\...../..................
..../..............-..|...|.........-.........\.....-...........-.....|...\.-....-../.................\.......
........\.|........\\.........-...............-.......-..................................../..........|.......
...............-...................\/...............\..-\...........|.-........-.\-.....\....\..../......-....
.../-......./..............|.......|..//......-....................../.|....\......|..\.........../-\.........
.-....|./....-.../....../.....-..............\..-..\..-............\................|...|..........-.......|..
|......../...................\..../....\......./..|.................\...............\.........\../.|......../.
../............/........|..|.......................................\../\...............\............/.......\.
........-.-...\........../.......-....-............./.............-......./................\..........-.......
.../-................/......|/........-......|..........|..-..............|/..........................-.......
......./............../...................|../...../................./../..........\../.....\....\............
..............-..|../-........................|...\.../...-/..........\.......\......\.................-....-.
......................................-/.\........................../......-..\..\........\...............|..\
.............-.........../-|........-........\....-.....\....../..\........................\......|.......\...
.././....................|\.../\.........\.|.............../..../...|......./.\...|.......\.........|.........
......................./........./-./...........................|/...\........-.../.................||........
..............|./........\..............\.............................|/................../............|.-..|.
.........................-......../........./.....|....-..-.-..............-.-......../.......\...\./.........
.-............../../....\//......../...|......|......\..................-......\.....-....\|.........|........
..............-.....................\.................\.|...-............................|......\.............
\\.....|...........\............|............................../............................................\.
.-........../|...\..............-...............................\...........\.....|......\..........\.........
.\............\.|....-........./....../../.....-..\........|...............-..................|............-.|
.....\......-.........-.........|....../..-....|.....\..../....|........-.....................................
..........\-..-..../\.....................\.........-...........|..../-.......................\....-..........
...../............./..|..................../............../../.........|...............-../...................
.....|...../.....|......-.............................|...........-......................./............/......
.....................||./.-.................-.........\.\..................-..............\...--.........\....
.|......-......-.\.......-......\....\..\..|.........../......./.....................-..........|.............
.....\.....\............................--..................|..-........\....\...\.|.\.-...........\...\......
./...........\.......\/......|........./..|................\-................/....\...................\.\.....
..|...............................-.........-.|/......|.....|........\........................................
.......|............-............../............-......../..-...\|-...-..../...........-..........-..-/.......
............................-..\.......................................-.........................\..........-.
........................\.........|................||...-....\......\.....\.................\...\\....../.....
....\../.....-.......-.................-|...................-../.|-............|........-|......./../...\.....
..................................................\.......|......./..\./......../....|....-|.-................
....../.........|.......|...|.......\.../|...............-.......-\..\......././..................|..\.|...../
............|.....\...........-.............................../.....-.................-.../............/.../..
...../.......\............................|.....\....\................/..................\......../...........
..................-....\.........\|................/|......../.-................|...\......................--.
......-..-.....................................-\.........|.../.....................|..|.-.....\...|....\....-
......-......-.................-......|..................................................|....................
..\...............|......../........-......./.............../...........-..........|/.....///\.....-..........
.........../..|.............../..........\|.........................\...|.....\||....\...|.|/.....-....../....
...../...../.....-............................................|........|............|.........................
......-../\................../..............\............\.................../|...........|.............\.....
...........-..........................-....\..\..|.-..............................................\........|..
/.--..//....\...............................-............|..././..............................................
/...............|.........../..../......................\.....|............|...........|...................-..
..-................\../|......../...................../...........\..|.|\../..................................
....|...../.....-......\.........................-.....//...............|.........-.......|...-....--.........
....|..\.-..../....................|..........\............./...........\.../.................................
............................\...................................../.......................|...........\.......
.........../.....-.....................\..\.-..|............-...............\.........................-.......
......-.......-\.\......\..-.-........./...........\..........|........................\.....-.....\..........
..............-....../.-............./........../..............\-....-.../...../.-............\......./.-.....
......|...................................................||..../...|\.....................-.../...\........|.
......|.//........................-...../...........-..\...|......|..................../........../...........
.....................................................|.........//...........|\.....\....................|.../.
............-..||...........|....../....................\...\................................../.......|......
..\....\......./-\.\...........-\................|.........../................||.../.....-...........\........
